####################
#.        #.       #
#     $ ###        #
#   @   # #  #  ####
#      ####  #  #
#     #.  ####  #
#    #    #  $  ####
#         $        #
#         #        #
####################
