"##### ##############",
"#.. # #    #      .#",
"#   # #$      $@####",
"## ####   ### # #   ",
" # $ #    #.# # #   ",
"## # #    # #.# ####",
"#      # ## # # $  #",
"## #$       # # ## #",
"#     #####   #    #",
"####################",