####################
# .#@ #      #    .#
#  # $##$##  #  ####
#  ## #         #  #
#            #  #  #
#  #      #$ #  ####
#         #  #     #
#  #### $ #####    #
#.   #    #.       #
####################
