####################
#.@.   #   #       #
#   #  #####       #
# # #           #  #
#   # #######   #  #
# ###       #   #  #
# $   # $   #   #. #
# #$  #       # ####
#     #     #      #
####################
