#####      #########
############       #
#    $  ...     #  #
#    ########## ####
#### ########## #   
#### ########## ####
#@ $          $    #
##     ######## ## #
#      #      #    #
########      ######