level:5
##### ##############
#.. # #    #      .#
#   # #$      $@####
## ####   ### # #   
 # $ #    #.# # #   
## # #    # #.# ####
#      # ## # # $  #
## #$       # # ## #
#     #####   #    #
####################

