"#####      #########",
"############       #",
"#    $  ...     #  #",
"#    ########## ####",
"#### ########## #   ",
"#### ########## ####",
"#@ $          $    #",
"##     ######## ## #",
"#      #      #    #",
"########      ######",