Nivel:1
####################
#.        #.       #
#     $ ###        #
#       # #  #  ####
#  @   ####  #  #   
#     #.  ####  #   
#    #    #  $  ####
#         $        #
#         #        #
####################
