Nivel:1
####################
#.        #.       #
#     $ ###        #
#       # #  #  ####
#      ####  #  #   
#     #.  ####  #   
#  @ #    #  $  ####
#         $        #
#         #        #
####################
Player:3,6
