Nivel:2
####################
#. .   #   #       #
#@  #  #####       #
# # #           #  #
#   # #######   #  #
# ###       #   #  #
# $   # $   #   #. #
# #$  #       # ####
#     #     #      #
####################
Player:1,2
